0,0,0,0,0,0,0,0,0
0,9,0,3,1,1,1,1,0
0,1,0,1,0,1,0,1,4
0,1,1,1,1,1,0,1,0
0,0,1,0,0,1,4,1,0
0,0,1,0,1,1,0,1,0
0,0,1,0,1,0,0,1,0
3,1,1,1,1,1,1,6,0
0,0,0,0,0,0,0,0,0